NO ./path_to_the_north_texture
WE ./path_to_the_west_texture
SO ./path_to_the_south_texture
EA ./path_to_the_east_texture


C 225,30,5
F 220,100,255


        111111111111 1111111111111
        100000000011 1000000000001
        101100000111100000100000001
        10010000001000000000000011
111111111011000001010000000100001
100000000011000001110111111111111
11110111111111011110000010111
11110111111111011101010010011                     
11000000110101011100000010001
1000000000000001100000010001
10000000000000001101010010001
11000001110101011111011110111
11110111 1110101 101111010W001
11111111 1111111 111111111111