NO ./textures/night.xpm
WE ./textures/night2.xpm
SO ./textures/night3.xpm
EA ./textures/night4.xpm


C 63,59,108
F 64,66,88

    1111111111111111111111111
    10000000000000000000000001
    1011000001110000000000001
    100100000000000000000000111111111
111111111011000001110000000000001
100000000011000001110111111111111
1111011111111100000000N10001
11110111111111000001010010001
11000000110101011100000010001
10000000000000001100000010001
10000000000000001101010000001
11000001110101011111000000111          11111111                       
11110111 1110101 101111010001          10000001
11111111 1111111 111111111111          11111111