111111111111111111111111111111111111111111
1S0000000011000000000000010101010101010101
101100000111000000000000100010001010101010
100100000000000000000000000000000000000001
111111111011000001110000000000000000000001
100000000011000001110111000000000000000001
111101111111110111000000000000000000000001
111101111111110111010100000000000000000001