NO ./path_to_the_north_texture
WE ./path_to_the_west_texture
SO ./path_to_the_south_texture
EA ./path_to_the_east_texture


C 225,30,5
F 220,100,255

    1111111111111111111111111
    10000000000000000000000001
    1011000001110000000000001
    100100000000000000000000111111111
111111111011000001110000000000001
100000000011000001110111111111111
11110111111111000000000010001
11110111111111000001010010001
11000000110101011100000010001
10000000000000001100000010001
10000000000000001101010000001
1100000111010101111100000N0111
11110111 1110101 101111010001
11111111 1111111 111111111111